##########
####__~###
##__*+_###
##__+*+_##
####_@*_##
####___###
##########
