##########
##########
##+____###
##**___###
##~+_#####
##########
##########
