##########
#___#___##
#_~_*_#+##
####**_++#
####_#___#
####___###
##########
