##########
#___#__###
#+_++*_###
##*##*__##
#_______##
#_~_######
##########
